1111111111
1000000001
1P00000011
1110000001
1C10000M11
10001M00C1
1C00010001
1110000011
100C00M0E1
1111111111
