11111111111111111111111111111
100100000001001100000000000E1
11C010010000100100001000000001
100000M0000C00M00C00000100001
1P00001000000000000M000100001
11111111111111111111111111111

