11111111111111111111111111111
100P00000001001100000000000E1
1C0100E0000100100001000000001
100000M0000C00M00C00000100001
1E00001000000000000M000100001
11111111111111111111111111111

