11111111111111111111111111111
100100000001001100000000000E1
1C01001000010010000100000000 
100000M0000C00M00C00000100001
1P00001000000000000M000100001
11111111111111111111111111111

