111111111111
1M01000000E1
1CM100100001
1M0000M00001
1P00001000C1
111111111111

