1111111111111111
10010000000100E1
1C01001000010011
100000M0000C01C1
1P00001000000011
1111111111111111
