11111111111111111111111111111111111111111111111111111111111111111111111111111111111111111111111111111111111
100100000001001100000000000E0000000000000000000000000000000000000000000000000000000000000000000000000000001
1C010010000100100001000000000000000000000000000000000000000000000000000000000000000000000000000000000000001
100000M0000C00M00C00000100000000000000000000000000000000000000000000000000000000000000000000000000000000001
1P00001000000000000M000100000000000000000000000000000000000000000000000000000000000000000000000000000000001
11111111111111111111111111111111111111111111111111111111111111111111111111111111111111111111111111111111111

