11111111111111111111111111111
10010000000100110000000000E11
1C010010000100100001000000011
100000M0000C00M00C00000100011
1P00001000000000000M000100011
11111111111111111111111111111

