11111111111111111111111111111
1C0100100001001000010000000E1
100000M0000C00M00C00000100001
1P00001000000000000M000100001
11111111111111111111111111111
11111111111111111111111111111

